 0  0  0  0  0  0  0  0  0  0  0  0  0  0  0  0 
 0  0  0  0  0  0  0  0  0  0  0  0  0  0  0  0 
 0  0  0  0  0  0  0  0  0  0  0  0  0  0  0  0 
 0  0  0  0  0  0  0  0  0  0  0  0  0  0  0  0 
 0  0  0  0  0  0  0  0  0  0  0  0  0  0  0  0 
 0  0  0  0  0  0  0  0  0  0  0  0  0  0  0  0 
 0  0  0  0  0  0  0  0  0  0  0  0  0  0  0  0 
 0  0  0  0  0  0  0  0  0  0  0  0  0  0  0  0 
 0  0  0  0  0  0  0  0  0  0  0  0  0  0  0  0 
 0  0  0  0  0  0  0  0  0  0  0  0  0  0  0  0 
 0  0  0  0  0  0  0  0  0  0  0  0  0  0  0  0 
 0  0  0  0  0  0  0  0  0  0  0  0  0  0  0  0 
 0  0  0  0  0  0  0  0  0  0  0  0  0  0  0  0 
 0  0  0  0  0  0  0  0  0  0  0  0  0  0  0  0 
 0  0  0  0  0  0  0  0  0  0  0  0  0  0 11 11 
 0  0  0  0  0  0  0  0  0  0  0  0  0 51 11 11 
 0  0  0  0  0  0  0  0  0  0  0  0  0 11 11 11 
 0  0  0  0  0  0  0  0  0  0  0  0 51 11 21 31 
 0  0  0  0  0  0  0  0  0  0  0  0 11 11  0  0 
 0  0  0  0  0  0  0  0  0  0  0 51 11 21  0  0 
 0  0  0  0  0  0  0 51 11 11 11 11 11  0  0  0 
 0  0  0  0  0  0 11 11 11 21  0  0  0  0  0  0 
 0  0  0  0  0  0 11 11 11  0  0  0 11 11 11  0 
 0  0  0  0  0  0 11 11 11  0  0  0 11 11 11 11 
 0  0  0  0  0 51 11 11 11  0  0  0 11 11 11 11 
 0  0  0  0  0 11 11 11 11  0  0  0  0 11 11 11 
 0  0  0  0  0 11 21  0  0  0  0  0 51 11 11 11 
 0  0  0  0 51 11  0  0  0  0  0 51 11 11 11 11 
 0  0 51 11 11 11  0  0  0  0 51 11 11 11 11 11 
 0 51 11 11 21  0  0  0  0 51 11 11 11 11 11 11 
11 11 11 21  0  0  0  0 51 11 11 11 11 11 11 11 
21  0  0  0  0  0  0 11 11 11 11 11 11 11 21  0 
