 0  0  0  0  0  0  0 11  0  0  0  0  0  0  0  0 
 0  0  0  0  0  0  0 11  0  0  0  0  0  0  0  0 
 0  0  0  0  0  0  0 11  0  0  0  0  0  0  0  0 
 0  0  0  0  0  0  0 11  0  0  0  0  0  0  0  0 
 0  0  0  0  0  0  0 11  0  0  0  0  0  0  0  0 
 0  0  0  0  0  0  0 11  0  0  0  0  0  0  0  0 
 0  0  0  0  0  0  0 11  0  0  0  0 11 41  0  0 
 0  0  0  0  0  0  0 11 41  0  0  0 11 11  0  0 
 0  0  0  0  0  0 51 11 11  0  0  0 11 11  0  0 
 0  0  0  0  0  0 11 11 11  0  0  0  0  0  0  0 
 0  0  0  0  0  0 31 11 11  0  0  0  0  0  0  0 
 0  0  0  0  0  0  0 11 21  0  0  0  0  0  0  0 
 0  0  0  0  0  0 51 11  0  0  0  0  0  0  0  0 
 0  0  0  0  0  0 11 11  0  0  0  0  0  0  0  0 
 0  0  0  0  0  0 11 21  0  0  0  0  0  0  0  0 
 0  0  0  0  0  0 11  0  0  0  0  0  0  0  0  0 
 0  0  0  0  0  0 11  0  0  0  0  0  0  0  0  0 
 0  0  0  0  0  0 11  0  0  0  0  0  0  0  0  0 
 0  0  0  0  0  0 11  0  0  0  0  0  0  0  0  0 
 0  0  0  0  0 51 11  0  0  0  0  0 11 11 11  0 
 0  0  0  0  0 11 11  0  0  0  0  0 11 11 11  0 
 0  0  0  0  0 11 21  0  0  0  0  0 31 11 21  0 
 0  0  0  0 51 11  0  0  0  0  0  0  0  0  0  0 
 0  0  0  0 11 11 41  0  0  0  0  0  0  0  0  0 
 0  0  0  0 11 11 11  0  0  0  0  0  0  0  0  0 
 0  0  0  0 11 11 11  0  0  0  0  0  0  0  0  0 
 0  0  0  0 11 11 11 41  0  0  0  0  0  0  0  0 
 0  0  0 51 11 11 11 11 41  0  0  0  0  0  0  0 
 0  0  0 11 11 21 31 11 11  0  0  0  0  0  0  0 
 0  0 51 11 21  0  0 31 11  0  0  0  0  0  0  0 
 0  0 11 11  0  0  0  0 11  0  0  0  0  0  0  0 
 0 51 11 21  0  0  0  0 11  0  0  0  0  0  0  0 
